0
==================================================
=                                                =
=                                                =
=                       ====                     =
=                                                =
=                    =                           =
=                    =                           =
=                 P=====                         =
==================================================