==================================================
=                                                =
=                                                =
=                       ====                     =
=                                                =
=                    =                           =
=                    =                           =
=                 p=====                         =
==================================================