====================================
=     |/ EK                        =
=     |\                           =
=                       ====       =
=         ===                      =
=                    =             =
=                    =             =
=                 p=====           =
====================================